-------------------------------------------------------------------------------
<-Name->|<- code ->|<--  Units   -->|<- Tile (max=80c)
-------------------------------------------------------------------------------
SIarea  |SM      M1|m^2/m^2         |SEAICE fractional ice-covered area [0 to 1]
SIareaPR|SM      M1|m^2/m^2         |SIarea preceeding ridging process
SIareaPT|SM      M1|m^2/m^2         |SIarea preceeding thermodynamic growth/melt
SIheff  |SM      M1|m               |SEAICE effective ice thickness
SIheffPT|SM      M1|m               |SIheff preceeeding thermodynamic growth/melt
SIhsnow |SM      M1|m               |SEAICE effective snow thickness
SIhsnoPT|SM      M1|m               |SIhsnow preceeeding thermodynamic growth/melt
SIhsalt |SM      M1|g/m^2           |SEAICE effective salinity
SIenpa  |SM      M1|W/m^2           |SEAICE power input by surface wind stresses
SIenpw  |SM      M1|W/m^2           |SEAICE work done by ocean drag
SIenph  |SM      M1|W/m^2           |SEAICE power due to change in inertia
SIenpg  |SM      M1|W/m^2           |SEAICE work generated by gravity
SIenpi  |SM      M1|W/m^2           |SEAICE work done by internal stress
SIenpot |SM      M1|W/m^2           |SEAICE work done to change potential energy
SIpRfric|SM      M1|W/m^2           |SEAICE dissipation in ridging by internal stresses
SIpSfric|SM      M1|W/m^2           |SEAICE dissipation in shearing by internal stresses
SItr##  |SM  C   M1|[SItr]          |<SItrNameLong> (associated with SItrMate(iTr))
SItr##PT|SM  C   M1|[SItr]          |SItr## preceeeding thermodynamic growth/melt
SItices |SM  C   M1|K               |Surface Temperature over Sea-Ice (area weighted)
SIuice  |UZ      M1|m/s             |SEAICE zonal ice velocity, >0 from West to East
SIvice  |VZ      M1|m/s             |SEAICE merid. ice velocity, >0 from South to North
SItaux  |UU      U1|N/m^2           |SEAICE zonal surface wind stress, >0 increases uIce
SItauy  |VV      U1|N/m^2           |SEAICE merid surface wind stress, >0 increases vIce
SIatmTx |UU      U1|N/m^2           |Zonal surface wind stress over Ocean+SeaIce
SIatmTy |VV      U1|N/m^2           |Merid surface wind stress over Ocean+SeaIce
SIqnet  |SM      U1|W/m^2           |Ocean surface heatflux, turb+rad, >0 decreases theta
SIqsw   |SM      U1|W/m^2           |Ocean surface shortwave radiat., >0 decreases theta
SIatmQnt|SM      U1|W/m^2           |Net atmospheric heat flux, >0 decreases theta
SItflux |SM      U1|W/m^2           |Same as TFLUX but incl seaice (>0 incr T decr H)
SIaaflux|SM      U1|W/m^2           |conservative ocn<->seaice adv. heat flux adjust.
SIhl    |SM      U1|W/m^2           |Latent heat flux into ocean, >0 increases theta
SIqneto |SM      U1|W/m^2           |Open Ocean Part of SIqnet, turb+rad, >0 decr theta
SIqneti |SM      U1|W/m^2           |Ice Covered Part of SIqnet, turb+rad, >0 decr theta
SIempmr |SM      U1|kg/m^2/s        |Ocean surface freshwater flux, > 0 increases salt
SIatmFW |SM      U1|kg/m^2/s        |Net freshwater flux from atmosphere & land (+=down)
SIsnPrcp|SM      U1|kg/m^2/s        |Snow precip. (+=dw) over Sea-Ice (area weighted)
SIfwSubl|SM      U1|kg/m^2/s        |Potential sublimation freshwater flux, >0 decr. ice
SIacSubl|SM      U1|kg/m^2/s        |Actual sublimation freshwater flux, >0 decr. ice
SIrsSubl|SM      U1|kg/m^2/s        |Residual subl. freshwater flux, >0 taken from ocn
SIactLHF|SM      U1|W/m^2           |Actual latent heat flux over ice
SImaxLHF|SM      U1|W/m^2           |Maximum latent heat flux over ice
SItr##Fx|SM      M1|[SItr].kg/m^2/s |SItr## flux out of ice pack (that may enter ocean)
SIaQbOCN|SM      M1|m/s             |Potential HEFF rate of change by ocean ice flux
SIaQbATC|SM      M1|m/s             |Potential HEFF rate of change by atm flux over ice
SIaQbATO|SM      M1|m/s             |Potential HEFF rate of change by open ocn atm flux
SIdHbOCN|SM      M1|m/s             |HEFF rate of change by ocean ice flux
SIdSbATC|SM      M1|m/s             |HSNOW rate of change by atm flux over sea ice
SIdSbOCN|SM      M1|m/s             |HSNOW rate of change by ocean ice flux
SIdHbATC|SM      M1|m/s             |HEFF rate of change by atm flux over sea ice
SIdHbATO|SM      M1|m/s             |HEFF rate of change by open ocn atm flux
SIdHbFLO|SM      M1|m/s             |HEFF rate of change by flooding snow
SIgrsLT |SM      M1|m               |actual grease ice layer thickness
SIdAbATO|SM      M1|m^2/m^2/s       |Potential AREA rate of change by open ocn atm flux
SIdAbATC|SM      M1|m^2/m^2/s       |Potential AREA rate of change by atm flux over ice
SIdAbOCN|SM      M1|m^2/m^2/s       |Potential AREA rate of change by ocean ice flux
SIdA    |SM      M1|m^2/m^2/s       |AREA rate of change (net)
ADVxHEFF|UU      M1|m.m^2/s         |Zonal      Advective Flux of eff ice thickn
ADVyHEFF|VV      M1|m.m^2/s         |Meridional Advective Flux of eff ice thickn
DFxEHEFF|UU      M1|m.m^2/s         |Zonal      Diffusive Flux of eff ice thickn
DFyEHEFF|VV      M1|m.m^2/s         |Meridional Diffusive Flux of eff ice thickn
ADVxAREA|UU      M1|m^2/m^2.m^2/s   |Zonal      Advective Flux of fract area
ADVyAREA|VV      M1|m^2/m^2.m^2/s   |Meridional Advective Flux of fract area
DFxEAREA|UU      M1|m^2/m^2.m^2/s   |Zonal      Diffusive Flux of fract area
DFyEAREA|VV      M1|m^2/m^2.m^2/s   |Meridional Diffusive Flux of fract area
ADVxSNOW|UU      M1|m.m^2/s         |Zonal      Advective Flux of eff snow thickn
ADVySNOW|VV      M1|m.m^2/s         |Meridional Advective Flux of eff snow thickn
DFxESNOW|UU      M1|m.m^2/s         |Zonal      Diffusive Flux of eff snow thickn
DFyESNOW|VV      M1|m.m^2/s         |Meridional Diffusive Flux of eff snow thickn
ADVxSSLT|UU      M1|g/kg.m^2/s      |Zonal      Advective Flux of seaice salinity
ADVySSLT|VV      M1|g/kg.m^2/s      |Meridional Advective Flux of seaice salinity
DFxESSLT|UU      M1|g/kg.m^2/s      |Zonal      Diffusive Flux of seaice salinity
DFyESSLT|VV      M1|g/kg.m^2/s      |Meridional Diffusive Flux of seaice salinity
SIuheff |UU      M1|m^2/s           |Zonal      Transport of eff ice thickn (centered)
SIvheff |VV      M1|m^2/s           |Meridional Transport of eff ice thickn (centered)
SIpress |SM      M1|N/m             |SEAICE strength (with upper and lower limit)
SIzeta  |SM      M1|kg/s            |SEAICE nonlinear bulk viscosity
SIeta   |SM      M1|kg/s            |SEAICE nonlinear shear viscosity
SIsig1  |SM      M1|no units        |SEAICE normalized principle stress, component one
SIsig2  |SM      M1|no units        |SEAICE normalized principle stress, component two
SIshear |SM      M1|1/s             |SEAICE shear deformation rate
SIdelta |SM      M1|1/s             |SEAICE Delta deformation rate
SItensil|SM      M1|N/m             |SEAICE maximal tensile strength
SIheffN |SM      MX|m               |SEAICE effective ice thickness per category
SIareaN |SM      MX|m^2/m^2         |SEAICE fractional ice-covered area per category [0 to 1]
SIhsnowN|SM      MX|m               |SEAICE effective snow thickness per category
ADJarea |SM A    M1|dJ/(m^2/m^2)    |dJ/darea: Sensitivity to seaice fractional ice-cover
ADJheff |SM A    M1|dJ/dm           |dJ/dheff: Sensitvity to seaice ice thickness
ADJhsnow|SM A    M1|dJ/dm           |dJ/dhsnow: Sensitivity to seaice snow thickness
ADJuice |UZ A    M1|dJ/(m/s)        |dJ/duice: sensitivity to zonal ice velocity
ADJvice |VZ A    M1|dJ/(m/s)        |dJ/dvice: sensitivity to meridional ice velocity

## = seaice tracer number
[SItr] = SItrUnit(##) or kg/kg if mate HEFF or kg/m^2
